800
WWWWWWWWWWWWWWWWWWWWWWWWWWWWWWWWWWWWWWWWWWWWWWWWWWWWWWWWWWWWWWWWWWWWWWWWWWWWWWWWWWWWWWWWWWWWWWWWWWWWWWWWWWWWWWW
WWWWWWWWWWWWWWWWWWWWWWWWWWWWWWWWWWWWWWWWWWWWWWWWWWWWWWWWWWWWWWW                                   WWWWWWWWWWWWW
WWWWWWWWWWWWWWWWWWWWWWWWWWWWWWWWWWWWWWWWWWWWWWWWWWWWWWWWWWWWWW                                    DWWWWWWWWWWWW
WWWWWWWWWWWWWWWWWWWWWWWWWWW      WWWWWWWWWWWWWW  WWWWWWWWWWWW    WWWW          WW                 DWWWWWWWWWWWW
WWWWWWWWWWW  W                    WWWWWWWWWWWWW  WWWWWWWWWWW    WWWWWWWWWWWW WWWWW              WWWWWWWWWWWWWWW
WWWW         W                                      WWWWWWW    WWWWWWWWWWWWW WWWWWW            WWWWW          W
W            W                                       WWWWW    WWWWWWWWWWWWWW WWWWWWW                          W
W            W                  WWW                          WWWWWWWWWWWWWWW WWWWWWWW                         W
W            W                 W           WWWWWWWW         WWWWWWWWWWWW         WWWWWWWWWWWWWWWWWWWW  WWWWWWWW
W            WW               W        WWWWWWWWWWWWW       WWWWWWWWWWWWW         WWWWWWWWWWWWWWWWWWWW  WWWWWWWW
W             W             W      WWWWWW                                                              WWWWWWWW
W             W             W      WW                  WWW                                             WWWWWWWW
W           WW            WWWWWWWWW            WWWWWWWWWWWWWWWWWWWWWWWWWWWWW  WWWWWWWWWWWWWWWWWWWWWWW  WWWWWWWW
W                     WWWW               WWWWWW                            W  WWWWWWWWWWWWWWWWWWWWWWW  WWWWWWWW
W               WWWWWWWWW            WWWW                                                           W      WWWW
W S  WWWWWWWWWW                  WWWW                                                                      WWWW
W    WWWWWWWWWW              WWWW                                                                          WWWW
WWWWWWWWWWWWWWWWWWWWWWWWWWWWWWWWWWWWWWWWWWWWWWWWWWWWWWWWWWWWWWWWWWWWWWWWWWWWWWWWWWWWWWWWWWWWWWWWWWWWWWWWWWWWWWW
