800
WWWWWWWWWWWWWWWWWWWWWWWWWWWWWWWWWWWWWWWWWWWWWWWWWWWWWWWWWWWWWWWWWWWWWWWWWWWWWWWWWWWWWWWWWWWWWWWWWWWWWWWWWWWWWWW
WWWWWWWWWWWWWWWWWWWWWWWWWWWWWWWWWWWWWWWWWWWWWWWWWWWWWWWWWWWWWWW                                   WWWWWWWWWWWWW
WWWWWWWWWWWWWWWWWWWWWWWWWWWWWWWWWWWWWWWWWWWWWWWWWWWWWWWWWWWWWW                                    DWWWWWWWWWWWW
WWWWWWWWWWWWWWWWWWWWWWWWWWW      WWWWWWWWWWWWWW  WWWWWWWWWWWW    WWWW          WW                 DWWWWWWWWWWWW
WWWWWWWWWWW  W                    WWWWWWWWWWWWW  WWWWWWWWWWW    WWWWWWWWWWWW WWWWW              WWWWWWWWWWWWWWW
WWWW         W                                      WWWWWWW    WWWWWWWWWWWWW WWWWWW            WWWWW          W
W            W                                       WWWWW    WWWWWWWWWWWWWW WWWWWWW                          W
W            W                                               WWWWWWWWWWWWWWW WWWWWWWW                         W
W            W                           WWWWWWWWWW         WWWWWWWWWWWW         WWWWWWWWWWWWWWWWWWWW  WWWWWWWW
W            WW                      WWWWWWWWWWWWWWW       WWWWWWWWWWWWW         WWWWWWWWWWWWWWWWWWWW  WWWWWWWW
W             W                    WWWWWWWWWWWWWWWWWWWWWW                                              WWWWWWWW
W             W                    WWWWWWWWWWWWWWWWWWWWWWW                                             WWWWWWWW
W           WW           WWWWWWWWWWWWWWWWWWWWWWWWWWWWWWWWWWWWWWWWWWWWWWWWWWW  WWWWWWWWWWWWWWWWWWWWWWW  WWWWWWWW
W                      WWW                                                 W  WWWWWWWWWWWWWWWWWWWWWWW  WWWWWWWW
W               WWWWWWWWW                                                                           W      WWWW
W S  WWWWWWWWWW                                                                                            WWWW
W   WWWWWWWWWWW                                                                                            WWWW
WWWWWWWWWWWWWWWWWWWWWWWWWWWWWWWWWWWWWWWWWWWWWWWWWWWWWWWWWWWWWWWWWWWWWWWWWWWWWWWWWWWWWWWWWWWWWWWWWWWWWWWWWWWWWWW
