1000
WWWWWWWWWWWWWWWWWWWWWWWWWWWWWWWWWWWWWWWWWWWWWWWWWWWWWWWWWWWWWWWWWWWWWWWWWWWWWWWWWWWWWWWWWWWWWWWWWWWWWWWWWWWWWWWWWWWWWWWWWWWWWWWWWWWWWWWWWWWWWWWWWWWWWWWWWWWWWWWWWWWWWWWWWWWWWWWWWWWWWWWWWWWWWWWWWWWWWW
W                                                                                                                                                                                                    W
W                                                                                                                                                                                                    W
W                                                                                                                                                                                                    W
W                                          WWWWWWWWWWWWW  W                                                                                                                                          W
W                                         W               W                                                                                                                                          W
W                                        W                W                                                                                                                                          W
W                                       W                 W                                                                                                                                          W
W                                      W                  W           W                                                                                                                              W
W                                     W                   W           W                                                                                                                              W
W                                    W                    W           W                                                                                                                              W
W                                   W                     W           W                                                                                                                              W
W                                  W                      W           W                                                                                                                              W
W                   WWW  WWWWWW WWW                       W          W                                                                                                                               W
W                  WW         W                           W         W                                                                                                                                W
W                 WW          W                           W         W                                                                                                                                W
W                WW    WWWWWWWW                           W        W                                                                                                                                 W
W               WW            W                            W      W                                                                                                                                  W
W              WW             W                            W     W                                                                                                                                   W
W             WWW             W                           W     W                                                                                                                                    W
W           WWWWWW            WWWW          WWWWWWWWW          WWWWWWWWWWWWW                                                                                                                         W
W  S                W   W  W        W   W                                         W   W   W                                                                                                          W
W                   W   W  W        W   W              W    W                 W W W W W W W  W                                                                                                       W
WWWWWWWWWWWWWWWWWWWWWWWWWWWWWWWWWWWWWWWWWWWWWWWWWWWWWWWWWWWWWWWWWWWWWWWWWWWWWWWWWWWWWWWWWWWWWWWWWWWWWWWWWWWWWWWWWWWWWWWWWWWWWWWWWWWWWWWWWWWWWWWWWWWWWWWWWWWWWWWWWWWWWWWWWWWWWWWWWWWWWWWWWWWWWWWWWWWWWW
