1000
WWWWWWWWWWWWWWWWWWWWWWWWWWWWWWWWWWWWWWWWWWWWWWWWWWWWWWWWWWWWWWWWWWWWWWWWWWWWWWWWWWWWWWWWWWWWWWWWWWWWWWWWWWWWWWWWWWWWWWWWWWWWWWWWWWWWWWWWWWWWWWWWWWWWWWWWWWWWWWWWWWWWWWWWWWWWWWWWWWWWWWWWWWWWWWWWWWWWWW
W                                                                                                                                                                                                    W
W                                                                                                                                                                                                    W
W                                                                                                                                                                                                    W
W                                          WWWWWWWWWWWWW  W                                                                                                                                          W
W                                         W               W                                                                                                                                          W
W                                        W                W                                                                                                                                          W
W                                       W                 W                                                                                                                                          W
W                                      W                  W                                                                                                                                          W
W                                     W                   W                                                                                                                                          W
W                                    W                    W                                                                                                                                          W
W                                   W                     W                                                                                                                                          W
W                                  W                      W                                                                                                                                          W
W                   WWW  WWWWWW WWW                       W                                                                                                                                          W
W                  WW         W                           W                                                                                                                                          W
W                 WW          W                           W                                                                                                                                          W
W                WW           W                           W                                                                                                                                          W
W               WW            W                            W                                                                                                                                         W
W              WW             W                            W                                                                                                                                         W
W             WWW             W                           W                                                                                                                                          W
W           WWWWWWWWWWWWWWWWWWWWWWWWWWWWWWWWWWWWWWWWWW    W   WWWWWWWWWWWWWW                                                                                                                         W
W  S                                                                                                                                                                                                 W
W                                                                                                                                                                                                    W
WWWWWWWWWWWWWWWWWWWWWWWWWWWWWWWWWWWWWWWWWWWWWWWWWWWWWWWWWWWWWWWWWWWWWWWWWWWWWWWWWWWWWWWWWWWWWWWWWWWWWWWWWWWWWWWWWWWWWWWWWWWWWWWWWWWWWWWWWWWWWWWWWWWWWWWWWWWWWWWWWWWWWWWWWWWWWWWWWWWWWWWWWWWWWWWWWWWWWW
