3000
WWWWWWWWWWWWWWWWWWWWWWWWWWWWWWWWWWWWWWWWWWWWWWWWWWWWWWWWWWWWWWWWWWWWWWWWWWWWWWWWWWWWWWWWWWWWWWWWWWWWWWWWWWWWWWWWWWWWWWWWWWWWWWWWWWWWWWWWWWWWWWWWWWWWWWWWWWWWWWWWWWWWWWWWWWWWWWWWWWWWWWWWWWWWWWWWWWWWWW
W      W                                   W  W  W                                                                                                                  WWWWW  WWWWW                     W
W      W                                   W  W  W                                                                                                                  W      W                         W
W      W                                   W  W  W                                                                                                                  W  WW  W  WW                     W
W      W                                   W  W  W                                                                                                                  W   W  W   W                     W
W      W                                   W  W  W                WWWW  WWW  W  W W  W                                                                              WWWWW  WWWWW                     W
W      W                                   W  W  W               W      W    W  W W  W                                                                                                               W
W      W                                   W  W  W              W       W    W  W W  W                                                                                                               W
W      W                                   W  W  W             WW       W    W  W W  W                               WWWWWWWWWWW                                                                     W
W      W                                   W  W  W            W W       W    W  W W  W                   WWWWWWWWWWWW           WWWWWWWWWWWW                                                         W
W     WW                                 WWW WW WW           W  W       W    W  W W  W   W              W                                   WWWWWWWWW                                                W
W  S                     W   W   W W W                      W   W       W    W  W W  W    W            W                                             WWWWWWWWWWW                                     W
W                        W   W   W W W                     W    W       W    W  W W  W     W          W                                                         WWWWWWWWWW                           W
WWWWWWWWWWWWWWWWWWWWWWWWWWWWWWWWWWWWWWWWWWWWWWWWWWWWWWWWWWWWWWWWWWWWWWWWWWWWWWWWWWWWWWWWWWWWWWWWWWWWWWWWWWWWWWWWWWWWWWWWWWWWWWWWWWWWWWWWWWWWWWWWWWWWWWWWWWWWWWWWWWWWWWWWWWWWWWWWWWWWWWWWWWWWWWWWWWWWWW
