1300
WWWWWWWWWWWWWWWWWWWWWWWWWWWWWWWWWWWWWWWWWWWWWWWWWWWWWWWWWWWWWWWWWWWWWWWWWWWWWWWWWWWWWWWWWWWWWWWWWWWWWWWWWWWWWWWWWWWWWWWWWWWWWWWWWWWWWWWWWWWWWWWWWWWWWWWWWWWWWWWW
W      W      W      W      W      W      W      W      W      W      W      W      W      W      W      W      W      W      W      W      W      W      W    W
W      W      W      W      W      W      W      W      W      W      W      W      W      W      W      W      W      W      W      W      W      W      W    W
W      W      W      W      W      W      W      W      W      W      W      W      W      W      W      W      W      W      W      W      W      W      W    W
W      W      W      W      W      W      W      W      W      W      W      W      W      W      W      W      W      W      W      W      W      W      W    W
W     WW     WW     WW     WW     WW     WW     WW     WW     WW     WW     WW     WW     WW     WW     WW     WW     WW     WW     WW     WW     WW     WW    W
W S                                                                                                                                                            W
W        W       W       W    W      W       W       W    W      W       W       W    W      W       W       W    W      W       W       W    W      W         W
WWWWWWWWWWWWWWWWWWWWWWWWWWWWWWWWWWWWWWWWWWWWWWWWWWWWWWWWWWWWWWWWWWWWWWWWWWWWWWWWWWWWWWWWWWWWWWWWWWWWWWWWWWWWWWWWWWWWWWWWWWWWWWWWWWWWWWWWWWWWWWWWWWWWWWWWWWWWWWWW
