WWWWWWWWWWWWWWWWWWWWWWWWWWWWWWWW
W                              W
W                              W
W                              W
W                              W
W                              W
W                              W
W                              W
W                              W
W                              W
W                              W
W                              W
W                              W
W                              W
W                              W
W                              W
W                              W
W                              W
W                              W
W                    DD        W
W              WWWWWWWWW       W
W                              W
W      WWWWWWW                 W
W                              W
W  WWWW   WWW WW               W
W                 WWWW W       W
W                              W
W           WWWWWW             W
W                              W
W S   WWWWWW                   W
W                              W
WWWWWWWWWWWWWWWWWWWWWWWWWWWWWWWW
