800
WWWWWWWWWWWWWWWWWWWWWWWWWWWWWWWWWWWWWWWWWWWWWWWWWWWWWWWWWWWWWWWWWWWWWWWWWWWWWWWWWWWWWWWWWWWWWWWWWWWWWWWWWWWWWWW
WWWWWWWWWWWWWWWWWWWWWWWWWWWWWWWWWWWWWWWWWWWWWWWWWWWWWWWWWWWWWWW                                   WWWWWWWWWWWWW
WWWWWWWWWWWWWWWWWWWWWWWWWWWWWWWWWWWWWWWWWWWWWWWWWWWWWWWWWWWWWW                                    DWWWWWWWWWWWW
WWWWWWWWWWWWWWWWWWWWWWWWWWW      WWWWWWWWWWWWWW  WWWWWWWWWWWW    WWWW          WW                 DWWWWWWWWWWWW
WWWWWWWWWWW  W                    WWWWWWWWWWWWW  WWWWWWWWWWW    WWWWWWWWWWWW WWWWW              WWWWWWWWWWWWWWW
WWWW         W                                      WWWWWWW    WWWWWWWWWWWWW WWWWWW            WWWWW          W
W            W                WW                     WWWWW    WWWWWWWWWWWWWW WWWWWWW                         DW
W            W              WWWWWWWWWWWWWWWWWWWWWW   WWWW    WWWWWWWWWWWWWWW WWWWWWWW                        DW
W            W        WWWWWWWWWWWWWWWWWWWWWWWWWWWWW         WWWWWWWWWWWWWWWW WWWWWWWWWWWWWWWWWWWWWWWW  WWWWWWWW
W            WW      WWWWWWWWWWWWWWWWWWWWWWWWWWWWWWW       WWWWWWWWWWWWWWWWW WWWWWWWWWWWWWWWWWWWWWWWW  WWWWWWWW
W            DW     WWWWWWWWWWWWWWWWWWWWWWWWWWWWWWWWWWWWWWWWWWWWWWWWWWWWWWWW WWWWWWWWWWWWWWWWWWWWWWWW  WWWWWWWW
W            DW    WWWWWWWWWWWWWWWWWWWWWWWWWWWWWWWWWWWWWWWWWWWWWWWWWWWWWWWWW WWWWWWWWWWWWWWWWWWWWWWWW  WWWWWWWW
W           WWW   WWWWWWWWWWWWWWWWWWWWWWWWWWWWWWWWWWWWWWWWWWWWWWWWWWWWWWWWWW WWWWWWWWWWWWWWWWWWWWWWWW  WWWWWWWW
W                WWWWWWWWWWWWWWWWWWWWWWWWWWWWWWWWWWWWWWWWWWWWWWWWWWWWWWWWWWW WWWWWWWWWWWWWWWWWWWWWWWW  WWWWWWWW
W               WWWWWWWWWWWWWWWWWWWWWWWWWWWWWWWWWWWWWWWWWWWWWWWWWWWWWWWWWWWW                        W      WWWW
W S  WWWWWWWWWWWWWWWWWWWWWWWWWWWWWWWWWWWWWWWWWWWWWWWWWWWWWWWWWWWWWWWWWWWWWWW                       DW     DWWWW
W   WWWWWWWWWWWWWWWWWWWWWWWWWWWWWWWWWWWWWWWWWWWWWWWWWWWWWWWWWWWWWWWWWWWWWWWW                       DW     DWWWW
WWWWWWWWWWWWWWWWWWWWWWWWWWWWWWWWWWWWWWWWWWWWWWWWWWWWWWWWWWWWWWWWWWWWWWWWWWWWWWWWWWWWWWWWWWWWWWWWWWWWWWWWWWWWWWW
